############
#         O#
#   P   ####
#          #
#######    #
#  O##     #
#   ##     #
#          #
#       XX #
#       #  #
############
