##########
#P       #
#     O  #
#  X     #
#        #
##########
